"filename", "language", "Rust", "comment", "blank", "total"
"c:\Users\Mercedes\Documents\VSCode Projects\IFmodPlugins\src\class.rs", "Rust", 79, 0, 8, 87
"c:\Users\Mercedes\Documents\VSCode Projects\IFmodPlugins\src\class\change.rs", "Rust", 6, 0, 0, 6
"c:\Users\Mercedes\Documents\VSCode Projects\IFmodPlugins\src\class\change\gender_lock.rs", "Rust", 28, 0, 5, 33
"c:\Users\Mercedes\Documents\VSCode Projects\IFmodPlugins\src\class\change\level.rs", "Rust", 115, 1, 15, 131
"c:\Users\Mercedes\Documents\VSCode Projects\IFmodPlugins\src\class\flag.rs", "Rust", 6, 0, 1, 7
"c:\Users\Mercedes\Documents\VSCode Projects\IFmodPlugins\src\class\move_type.rs", "Rust", 4, 0, 1, 5
"c:\Users\Mercedes\Documents\VSCode Projects\IFmodPlugins\src\class\skill.rs", "Rust", 23, 1, 6, 30
"c:\Users\Mercedes\Documents\VSCode Projects\IFmodPlugins\src\combat.rs", "Rust", 12, 0, 1, 13
"c:\Users\Mercedes\Documents\VSCode Projects\IFmodPlugins\src\combat\ai.rs", "Rust", 18, 0, 1, 19
"c:\Users\Mercedes\Documents\VSCode Projects\IFmodPlugins\src\combat\battle_info.rs", "Rust", 25, 0, 5, 30
"c:\Users\Mercedes\Documents\VSCode Projects\IFmodPlugins\src\combat\engage_count.rs", "Rust", 9, 0, 2, 11
"c:\Users\Mercedes\Documents\VSCode Projects\IFmodPlugins\src\combat\no_dynlv.rs", "Rust", 17, 1, 2, 20
"c:\Users\Mercedes\Documents\VSCode Projects\IFmodPlugins\src\combat\silence.rs", "Rust", 55, 1, 4, 60
"c:\Users\Mercedes\Documents\VSCode Projects\IFmodPlugins\src\combat\skill_point.rs", "Rust", 9, 0, 1, 10
"c:\Users\Mercedes\Documents\VSCode Projects\IFmodPlugins\src\item.rs", "Rust", 92, 0, 8, 100
"c:\Users\Mercedes\Documents\VSCode Projects\IFmodPlugins\src\item\check_use.rs", "Rust", 50, 1, 4, 55
"c:\Users\Mercedes\Documents\VSCode Projects\IFmodPlugins\src\item\flag.rs", "Rust", 2, 0, 1, 3
"c:\Users\Mercedes\Documents\VSCode Projects\IFmodPlugins\src\item\heal_override.rs", "Rust", 14, 2, 1, 17
"c:\Users\Mercedes\Documents\VSCode Projects\IFmodPlugins\src\item\kind.rs", "Rust", 21, 0, 1, 22
"c:\Users\Mercedes\Documents\VSCode Projects\IFmodPlugins\src\item\use_type.rs", "Rust", 43, 0, 1, 44
"c:\Users\Mercedes\Documents\VSCode Projects\IFmodPlugins\src\lib.rs", "Rust", 41, 23, 6, 70
"c:\Users\Mercedes\Documents\VSCode Projects\IFmodPlugins\src\map.rs", "Rust", 109, 9, 20, 138
"c:\Users\Mercedes\Documents\VSCode Projects\IFmodPlugins\src\menu.rs", "Rust", 10, 0, 1, 11
"c:\Users\Mercedes\Documents\VSCode Projects\IFmodPlugins\src\misc.rs", "Rust", 12, 0, 2, 14
"c:\Users\Mercedes\Documents\VSCode Projects\IFmodPlugins\src\misc\no_investment.rs", "Rust", 9, 0, 2, 11
"c:\Users\Mercedes\Documents\VSCode Projects\IFmodPlugins\src\misc\no_skirmishes.rs", "Rust", 11, 1, 2, 14
"c:\Users\Mercedes\Documents\VSCode Projects\IFmodPlugins\src\misc\no_well.rs", "Rust", 9, 0, 3, 12
"c:\Users\Mercedes\Documents\VSCode Projects\IFmodPlugins\src\misc\patch_msg.rs", "Rust", 31, 0, 3, 34
"c:\Users\Mercedes\Documents\VSCode Projects\IFmodPlugins\src\misc\save_header.rs", "Rust", 8, 0, 2, 10
"c:\Users\Mercedes\Documents\VSCode Projects\IFmodPlugins\src\skill.rs", "Rust", 48, 0, 7, 55
"c:\Users\Mercedes\Documents\VSCode Projects\IFmodPlugins\src\skill\canto.rs", "Rust", 59, 0, 5, 64
"c:\Users\Mercedes\Documents\VSCode Projects\IFmodPlugins\src\skill\flag.rs", "Rust", 2, 0, 1, 3
"c:\Users\Mercedes\Documents\VSCode Projects\IFmodPlugins\src\skill\map.rs", "Rust", 287, 23, 19, 329
"c:\Users\Mercedes\Documents\VSCode Projects\IFmodPlugins\src\skill\overlap.rs", "Rust", 30, 0, 1, 31
"c:\Users\Mercedes\Documents\VSCode Projects\IFmodPlugins\src\skill\weapon_expert.rs", "Rust", 20, 0, 2, 22
"c:\Users\Mercedes\Documents\VSCode Projects\IFmodPlugins\src\skill\winged_sheild.rs", "Rust", 58, 0, 7, 65
"c:\Users\Mercedes\Documents\VSCode Projects\IFmodPlugins\src\terrain.rs", "Rust", 18, 0, 2, 20
"c:\Users\Mercedes\Documents\VSCode Projects\IFmodPlugins\src\terrain\limit_expansion.rs", "Rust", 8, 0, 1, 9
"c:\Users\Mercedes\Documents\VSCode Projects\IFmodPlugins\src\terrain\percentage.rs", "Rust", 32, 0, 3, 35
"c:\Users\Mercedes\Documents\VSCode Projects\IFmodPlugins\src\unit.rs", "Rust", 104, 0, 12, 116
"c:\Users\Mercedes\Documents\VSCode Projects\IFmodPlugins\src\unit\capability.rs", "Rust", 20, 0, 3, 23
"c:\Users\Mercedes\Documents\VSCode Projects\IFmodPlugins\src\unit\capability\limit.rs", "Rust", 181, 0, 24, 205
"c:\Users\Mercedes\Documents\VSCode Projects\IFmodPlugins\src\unit\capability\multiplier.rs", "Rust", 117, 0, 3, 120
"c:\Users\Mercedes\Documents\VSCode Projects\IFmodPlugins\src\unit\status.rs", "Rust", 1, 0, 1, 2
"c:\Users\Mercedes\Documents\VSCode Projects\IFmodPlugins\src\util.rs", "Rust", 3, 0, 0, 3
"c:\Users\Mercedes\Documents\VSCode Projects\IFmodPlugins\src\util\bitmask.rs", "Rust", 21, 0, 5, 26
"c:\Users\Mercedes\Documents\VSCode Projects\IFmodPlugins\src\util\language.rs", "Rust", 7, 0, 2, 9
"c:\Users\Mercedes\Documents\VSCode Projects\IFmodPlugins\src\util\thread_safe.rs", "Rust", 32, 0, 7, 39
"Total", "-", 1916, 63, 214, 2193